111111111111
100E010000C1
1C0001E00001
1P000000C001
111111111111